12 9
0 0 0 0 0 0 0 0 0 0 0 0
0 9 1 1 1 1 1 10 0 0 0 0
0 3 0 0 0 0 0  2 0 0 0 0
0 3 0 0 0 0 0  2 0 0 0 0
0 3 0 0 0 0 0 0 8 0 0 0
0 3 0 0 0 0 0 0 0 1 10 0
0 3 0 0 0 0 0 0 0 0 2 0
0 12  4  4 4  4  4 4  4 4 11 0
0 0 0 0 0 0 0 0 0 0 0 0
